1111111111
1        1
1   2    1
1        1
1    2   1
1   2    1
1        1
1  2     1
1  2     1
3333333333