3333313333
2        2
2   3    2
2   3    1
2        2
2   2 2222
2        2
2222     2
2       2
3333313333