1111111111
1        1
1   22   1
1   2    1
1       11
12222    1
1       11
1  5   111
1  5     1
1111111111